module.exports = {
    AE: false, // "United Arab Emirates",
    AF: false, // "Afghanistan",
    AG: true, // "Antigua and Barbuda",
    AL: false, // "Albania",
    AM: false, // "Armenia",
    AO: false, // "Angola",
    AR: false, // "Argentina",
    AT: true, // "Austria",
    AU: true, // "Australia",
    AZ: false, // "Azerbaijan",
    BA: false, // "Bosnia-Herzegovina",
    BB: true, // "Barbados",
    BD: false, // "Bangladesh",
    BE: true, // "Belgium",
    BF: false, // "Burkina Faso",
    BG: false, // "Bulgaria",
    BH: false, // "Bahrain",
    BI: false, // "Burundi",
    BJ: false, // "Benin",
    BN: false, // "Brunei Darussalam",
    BO: false, // "Bolivia",
    BQBO: false, // "Bonaire",
    BR: false, // "Brazil",
    BS: false, // "Bahamas",
    BT: false, // "Bhutan",
    BW: false, // "Botswana",
    BY: false, // "Belarus",
    BZ: false, // "Belize",
    CA: true, // "Canada",
    CD: false, // "Democratic Republic of the Congo",
    CF: false, // "Central African Republic",
    CG: false, // "Republic of the Congo",
    CH: true, // "Switzerland",
    CI: false, // "Ivory Coast",
    CL: false, // "Chile",
    CM: false, // "Cameroon",
    CN: false, // "China",
    CO: false, // "Colombia",
    CR: false, // "Costa Rica",
    CU: false, // "Cuba",
    CV: false, // "Cape Verde",
    CY: true, // "Cyprus",
    CZ: false, // "Czech Republic",
    DE: true, // "Germany",
    DJ: false, // "Djibouti",
    DK: false, // "Denmark",
    DO: false, // "Dominican Republic",
    DZ: false, // "Algeria",
    EC: false, // "Ecuador",
    EE: false, // "Estonia",
    EG: true, // "Egypt",
    EH: false, // "Western Sahara",
    ER: false, // "Eritrea",
    ES: true, // "Spain",
    ET: false, // "Ethiopia",
    FI: false, // "Finland",
    FJ: false, // "Fiji",
    FK: false, // "Falkland Islands",
    FM: false, // "Micronesia",
    FR: true, // "France",
    GA: false, // "Gabon",
    GB: true, // "United Kingdom",
    GE: false, // "Georgia",
    GF: false, // "French Guyana",
    GH: false, // "Ghana",
    GL: false, // "Greenland",
    GM: false, // "Gambia",
    GN: false, // "Guinea",
    GQ: false, // "Equatorial Guinea",
    GR: true, // "Greece",
    GS: false, // "S. Georgia & S. Sandwich Isls.",
    GT: false, // "Guatemala",
    GW: false, // "Guinea Bissau",
    GY: false, // "Guyana",
    HN: false, // "Honduras",
    HR: true, // "Croatia",
    HT: false, // "Haiti",
    HU: false, // "Hungary",
    IC: true, // "Canary Islands",
    ID: false, // "Indonesia",
    IE: true, // "Ireland",
    IL: false, // "Israel",
    IN: false, // "India",
    IQ: false, // "Iraq",
    IR: false, // "Iran",
    IS: false, // "Iceland",
    IT: true, // "Italy",
    JM: false, // "Jamaica",
    JO: false, // "Jordan",
    JP: false, // "Japan",
    KE: false, // "Kenya",
    KG: false, // "Kyrgyzstan",
    KH: false, // "Cambodia",
    KP: false, // "North Korea",
    KR: false, // "South Korea",
    KW: false, // "Kuwait",
    KZ: false, // "Kazakhstan",
    LA: false, // "Laos",
    LB: false, // "Lebanon",
    LC: true, // "Saint Lucia",
    LK: false, // "Sri Lanka",
    LR: false, // "Liberia",
    LS: false, // "Lesotho",
    LT: false, // "Lithuania",
    LU: false, // "Luxembourg",
    LV: false, // "Latvia",
    LY: false, // "Libya",
    MA: false, // "Morocco",
    MD: false, // "Moldavia",
    ME: true, // "Montenegro",
    MG: false, // "Madagascar",
    MK: false, // "Macedonia",
    ML: false, // "Mali",
    MM: false, // "Myanmar",
    MN: false, // "Mongolia",
    MR: false, // "Mauritania",
    MW: false, // "Malawi",
    MX: true, // "Mexico",
    MY: false, // "Malaysia",
    MZ: false, // "Mozambique",
    NA: false, // "Namibia",
    NC: false, // "New Caledonia (French)",
    NE: false, // "Niger",
    NG: false, // "Nigeria",
    NI: false, // "Nicaragua",
    NL: false, // "Netherlands",
    NO: false, // "Norway",
    NP: false, // "Nepal",
    NZ: false, // "New Zealand",
    OM: false, // "Oman",
    PA: false, // "Panama",
    PE: false, // "Peru",
    PG: false, // "Papua New Guinea",
    PH: false, // "Philippines",
    PK: false, // "Pakistan",
    PL: false, // "Poland",
    PR: false, // "Puerto Rico",
    PS: false, // "Palestine",
    PT: false, // "Portugal",
    PW: false, // "Palau",
    PY: false, // "Paraguay",
    QA: false, // "Qatar",
    RO: false, // "Romania",
    RS: false, // "Serbia",
    RU: false, // "Russia",
    RW: false, // "Rwanda",
    SA: false, // "Saudi Arabia",
    SB: false, // "Solomon Islands",
    SD: false, // "Sudan",
    SE: false, // "Sweden",
    SI: false, // "Slovenia",
    SK: false, // "Slovak Republic",
    SL: false, // "Sierra Leone",
    SN: false, // "Senegal",
    SO: false, // "Somalia",
    SR: false, // "Suriname",
    SS: false, // "South Sudan",
    SV: false, // "El Salvador",
    SY: false, // "Syria",
    SZ: false, // "Swaziland",
    TD: false, // "Chad",
    TG: false, // "Togo",
    TH: false, // "Thailand",
    TJ: false, // "Tajikistan",
    TL: false, // "East Timor",
    TM: false, // "Turkmenistan",
    TN: false, // "Tunisia",
    TR: false, // "Turkey",
    TT: false, // "Trinidad and Tobago",
    TW: false, // "Taiwan",
    TZ: false, // "Tanzania",
    UA: false, // "Ukraine",
    UG: false, // "Uganda",
    US: true, // "United States",
    UY: false, // "Uruguay",
    UZ: false, // "Uzbekistan",
    VE: false, // "Venezuela",
    VN: false, // "Vietnam",
    VU: false, // "Vanuatu",
    XK: false, // "Kosovo",
    YE: false, // "Yemen",
    ZA: false, // "South Africa",
    ZM: false, // "Zambia",
    ZW: false, // "Zimbabwe"
}